S  I  R  E  G  A  T  O  P  A  T  I  S  S  I  E  R  I  
C  F  E  H  C  S  U  O  S  R  E  I  C  U  A  S  K  S  
H  E  C  E  N  I  S  I  U  C  E  D  F  E  H  C  M  Q  
S  H  U  D  R  A  R  E  I  S  S  I  T  O  R  E  O  E  
O  C  I  A  X  I  G  R  I  L  L  A  R  D  I  N  L  L  
U  G  S  G  F  E  H  C  E  V  I  T  U  C  E  X  E  L  
S  N  I  I  L  I  N  E  C  O  O  K  E  I  R  R  C  E  
V  I  N  R  E  S  T  A  U  R  A  N  T  U  U  E  U  V  
I  K  I  B  G  I  S  I  D  T  T  X  Q  I  T  I  L  U  
D  R  E  G  N  A  M  E  D  R  A  G  G  T  L  N  A  O  
E  O  R  F  S  S  R  U  E  Y  O  B  A  H  U  O  R  N  
M  W  N  A  C  C  A  M  R  E  I  F  F  O  C  S  E  O  
E  N  P  R  O  F  E  S  S  I  O  N  A  L  I  S  M  I  
R  K  O  O  C  T  S  A  F  K  A  E  R  B  R  I  A  S  
A  Y  K  B  I  Y  M  O  N  O  R  T  S  A  G  O  C  U  
C  A  U  E  L  B  A  N  I  A  T  S  U  S  A  P  U  F  
L  U  R  E  G  N  A  L  U  O  B  Y  R  E  K  O  O  C  
A  S  R  R  E  T  O  U  R  A  N  T  P  M  I  R  U  X