I C M I T S E V R A H T L L L
A E R A I P O C U N R O C R O
D L B S T U F F I N G F F C Y
I E C U A S Y R R E B N A R C
N B I A E N I G N R C N T O G
F R L P G P R T E M D C F U N
R A H N N G I W U I U F T G I
A T O O M I O L E R R T Y E R
E I L T F L K D G I K L U D E
M O I N F E Y P E R I E R A H
E N D Y E A A N M M I T Y R T
A S A E M E D S A U R M O A A
L M Y S I S U F T R P B S P G
