G  Y  P  U  Q  D  B  R  E  W  E  R  S  E
R  A  I  S  E  L  O  I  R  O  W  A  B  N
A  N  R  N  Y  C  U  B  S  H  S  W  L  L
N  K  A  A  K  A  U  A  I  E  R  T  U  I
G  E  T  I  T  S  R  T  I  S  E  M  E  Q
E  E  E  D  N  H  E  L  L  N  G  A  J  M
R  S  S  N  R  S  L  A  N  I  D  R  A  C
S  O  N  I  O  I  N  E  A  W  O  I  Y  I
X  R  I  X  H  O  I  S  T  T  D  N  S  U
O  O  L  P  I  S  T  N  A  I  G  E  L  W
S  E  R  T  B  R  A  V  E  S  C  R  E  U
D  I  A  M  O  N  D  B  A  C  K  S  G  S
E  N  M  S  E  R  D  A  P  E  U  R  N  I
R  O  Y  A  L  S  R  E  G  I  T  O  A  R